**********
*........*
*.******.*
*.*......*
*.*.**.*.*
*...*..*.*
*.*....*.*
*.******.*
*........*
**********