********************
*...****......**...*
*..****...***.***.**
**..**...****...*..*
***.....****.......*
******.........*****
*.......*****......*
*******.*********..*
*..................*
********************