********************
*..................*
*......******......*
*...........*......*
*****.......*......*
*...*..***..*..***.*
*...*....*..*....*.*
*...*..*.*..*....*.*
*...*..*.*..*....*.*
*......*.*..*....*.*
*......*.*..*....*.*
*......*.*..*....*.*
*......*....*....*.*
*......*....****.*.*
*..*...*****...*...*
*..*...........*...*
*..*....****...*...*
*..****..****..*...*
*..............*...*
********************